
[리눅스 기본 명령어]

$

1. 경로 이동 (change directory) : cd
	cd . : 현재 디렉토리
	cd .. : 상위 디렉토리
	cd ~ : home 디렉토리
	

2. 디렉토리 목록 확인 (list) : ls
	ls -lh : 보기종은 형태로 출력 (-l : 파일크기 옵션)

3. 파일이나 디렉토리 삭제 : rm
	rm abc.txt : 해당 파일을 삭제(내부적으로 'rm -i'로 연결됨)
	rm -r abc : 해당 디렉터리를 삭제(r은 Recursive의 약자) **-r 폴더 삭제할 때 
	
4. 파일이나 디렉토리 복사 : cp
	cp abc.txt cba.txt : abc.txt를 cba.txt라는 이름으로 바꿔서 복사
	cp -r abc cda : 디렉터리 복사
	
5. 파일이나 디렉토리 이름 변경, 이동 : mv
	mv abc.txt /etc/sysconfig/ : abc.txt을 /etc/sysconfig/ 디렉터리로 이동
	mv aaa bbb ccc ddd : aaa, bbb, ccc 파일을 /ddd 디렉터리로 이동
	mv abc.txt www.txt : abc.txt의 이름을 www.txt로 변경해서 이동
		
5. 디렉토리 생성 : mkdir
	mkdir abc : 현재 디렉터리 아래에 /abc 이름의 디렉터리 생성
	
6. 디렉토리 삭제 : rmdir
	rmdir abc : /abc 디렉터리를 삭제

7. 파일 내용 화면에 출력 : cat
	cat a.txt : a.txt 파일의 내용을 화면에 출력

8. 터미널 클리어 : clear

9. 파일 압축하거나 풀때 :
  tar -xvf rtems-5-1.3.2-src.txz

  tar [OPTION...] [FILE]...
        -f     : 대상 tar 아카이브 지정. (기본 옵션)
        -c     : tar 아카이브 생성. 기존 아카이브 덮어 쓰기. (파일 묶을 때 사용)
        -x     : tar 아카이브에서 파일 추출. (파일 풀 때 사용)
        -v     : 처리되는 과정(파일 정보)을 자세하게 나열.
        -z     : gzip 압축 적용 옵션.
        -j     : bzip2 압축 적용 옵션.
        -t     : tar 아카이브에 포함된 내용 확인.
        -C     : 대상 디렉토리 경로 지정.
        -A     : 지정된 파일을 tar 아카이브에 추가.
        -d     : tar 아카이브와 파일 시스템 간 차이점 검색.
        -r     : tar 아카이브의 마지막에 파일들 추가.
        -u     : tar 아카이브의 마지막에 파일들 추가.
        -k     : tar 아카이브 추출 시, 기존 파일 유지.
        -U     : tar 아카이브 추출 전, 기존 파일 삭제.
        -w     : 모든 진행 과정에 대해 확인 요청. (interactive)
        -e     : 첫 번째 에러 발생 시 중지.


** vi 편집기 : 명령 모드, 입력 모드, 마지막 행 모드로 구성되어있다.

1. 입력 모드 명령어
명령어	        기능
i	현재 커서의 위치부터 입력
I	현재 커서 줄의 맨 앞에서부터 입력
a	현재 커서의 다음 줄에 입력
A	현재 커서 줄의 맨 뒤에서부터 입력
o	현재 커서의 다음 줄에 입력
O	현재 커서의 이전 줄에 입력
s	현재 커서 위치에 한 글자를 지우고 입력
S	현재 커서의 한 줄을 지우고 입력

2. 명령 모드 명령어
명령어					기능
x	현재 커서가 위치한 문자 1개 삭제(5x: 문자 5개 삭제)
dw	커서가 위치한 곳에서부터 단어 삭제(커서가 위치한 곳부터 띄어쓰기 한 곳까지)
dd	커서가 위치한 곳의 한 줄 삭제(p로 복구 가능)
yy	커서가 위치한 곳의 한 줄 복사(5yy: 5줄 복사)
p	커서가 위치한 곳의 다음 줄에 내용 붙여넣기
	dd 잘라내기 -> p 붙여넣기
P	커서가 위치한 곳의 이전 줄에 내용 붙여넣기
u	직전에 내린 명령 취소

3. 명령 모드에서 커서 이동 명령어
명형어			기능
h			커서에서 왼쪽으로 한 칸 이동
j			커서에서 아래로 한 칸 이동
k			커서에서 위로 한 칸 이동
l			커서에서 오른쪽으로 한 칸 이동
gg			파일의 제일 첫 줄로 이동
G			파일의 제일 끝 줄로 이동(대문자로 입력해야함)
Ctrl + b	이전 화면으로 이동
Ctrl + f	다음 화면으로 이동

4. 마지막 행 모드(Last Line Mode) 명령어
명령어			기능
:w			현재 파일 명으로 저장
:q			vi 편집기 종료(저장안됨)
:q!			vi 편집기 강제 종료
:wq			저장 후 종료
:wq!		강제 저장 후 종료
:숫자			해당 숫자 라인으로 커서 이동
:e!			마지막 저장 이후 모든 편집 취소
/문자열		현재 커서에서부터 앞쪽으로 문자열 탐색
?문자열		현재 커서에서부터 뒷쪽으로 문자열 탐색
set nu		라인 번호 출력
set nonu	라인 번호 숨기기

***********************************************************************************
<우분투 apt cmd>

apt 패키지 매니저의 주요 명령어 (★ : 관리자 권한 필요)

- apt update : 패키지를 다운로드할 수 있는 저장소의 최신 정보를 업데이트한다. (★)
- apt list --upgradable : 업그레이드가 가능한 패키지 목록을 출력한다.
- apt upgrade : 전체 패키지를 업그레이드한다. (★)
- apt --only-upgrade install 패키지 이름 : 특정 패키지만 업그레이드한다. (★)
- apt install 패키지 이름 : 특정 패키지를 설치한다. (★)
- apt list --installed : 설치된 패키지 목록을 출력한다.
- apt search 검색어 : 패키지를 검색한다.
- apt show 패키지 이름 : 특정 패키지에 대한 정보를 확인한다.
- apt remove 패키지 이름 : 특정 패키지를 삭제한다. (★)


관리자 권한 사용하기

관리자 권한이 필요한 경우, sudo 명령어를 앞에 붙여 사용

- sudo apt update
- sudo apt install 패키지이름
- sudo apt remove 패키지이름
- sudo apt upgrade
- sudo apt --only-upgrade install 패키지이름


